111111111111111111
10000000C000000111
100101111110000111
10010000C0100C0001
100100100010000001
100100100010000101
1001C0100010000101
100100100011110101
10010010C010000101
1EC11111111C0001P1
111111111111111111