11111111111111111111
11E11C00000000000001
100010001000CCC00001
10C0100C111111110001
10001101100000000001
10001C0010000CCCC001
10C01000100111111111
1000100010010000P001
10000000100000000001
11111111111111111111