111111111111111111111111111
1000P0C01C100000C001111E111
100000001010000000011100111
100000000000000000011100111
100000000000000000011100111
100000000000000000011100111
10000C000000000000000100011
100011111111111110000100011
100000000000000000000100011
11000000000001C000000100011
110000000000010000000100011
110000011111110000000100011
110000000C00010000000000011
110000000000010000000000C11
111111111111111111111111111